111111111111111111111111111111111111111111111111111111111
1P0N0C0000N00C0111111111111111111111111111111111111111111
1E00000N1000000111111111111111111111111111111111111111111
1C1110000C0N001111111111111111111111111111111111111111111
100N010000N00C0111111111111111111111111111111111111111111
1000000N1000000111111111111111111111111111111111111111111
11110C00C00N001111111111111111111111111111111111111111111
111111111111111111111111111111111111111111111111111111111
111111111111111111111111111111111111111111111111111111111
111111111111111111111111111111111111111111111111111111111
111111111111111111111111111111111111111111111111111111111
111111111111111111111111111111111111111111111111111111111
111111111111111111111111111111111111111111111111111111111
111111111111111111111111111111111111111111111111111111111
111111111111111111111111111111111111111111111111111111111
111111111111111111111111111111111111111111111111111111111
111111111111111111111111111111111111111111111111111111111
111111111111111111111111111111111111111111111111111111111
111111111111111111111111111111111111111111111111111111111
111111111111111111111111111111111111111111111111111111111
111111111111111111111111111111111111111111111111111111111
111111111111111111111111111111111111111111111111111111111
111111111111111111111111111111111111111111111111111111111
111111111111111111111111111111111111111111111111111111111
111111111111111111111111111111111111111111111111111111111
111111111111111111111111111111111111111111111111111111111
111111111111111111111111111111111111111111111111111111111
111111111111111111111111111111111111111111111111111111111
111111111111111111111111111111111111111111111111111111111
111111111111111111111111111111111111111111111111111111111
111111111111111111111111111111111111111111111111111111111
111111111111111111111111111111111111111111111111111111111
111111111111111111111111111111111111111111111111111111111
111111111111111111111111111111111111111111111111111111111
111111111111111111111111111111111111111111111111111111111