1111111111111111
1P0N0C0000N00C01
1E00000N10000001
1C1110000C0N0011
100N010000N00C01
1000000N10000001
11110C00C00N0011
1111111111111111