11111111
1P0000E1
101C0N11
11111111