11111111
1100C101
10000001
1C0C1C01
1EP00001
11111111