111111
1P0C01
1000E1
100001
111110