111111
10C001
1EN0N1
1C0P01
111111