11111111
1P0000E1
101C0011
11111111