11111111
1P0000E1
101C0001
11111111