111111111111111111111111111111
1P00000000010000000C0000000001
1000011011000110001000000000C1
101111101001111000001111000001
10000000100100000C001000000001
10000000100C000000001000000001
101111101110001001101000000001
1000100001100011100010E0000001
10001000011000001000100000C001
100010000110000010000000010001
100011100110000010000000010001
101000000110000011000001100001
10000010011000000C000001000001
1C00000000000000001000C00000C1
111111111111111111111111111111
