111111111111111111111111111111
1P00000000010000000000000000E1
100000000100000000000000000001
101000000001000000000000000001
100000000001000000000000000001
10000000000C000000000000000001
100000000000000000000000000001
100000000000000000000000000001
100000000000000000100000000001
1000000000000000001000000C0001
100000000000000000000000000001
100000000000000011000000000001
10000000000000000C000000000001
100000000000000000000000000001
111111111111111111111111111111