1111111
1010001
1P1C001
1E10001
1111111